7 7
#######
#S# X #
# ### #
# #   #
# # # #
#   #E#
#######