7 7
#######
#S#   #
# ### #
# #S  #
# # # #
#   #E#
#######